...........    MAP:    ...........
.........| 8 |---|*9 |............
...........|......................
.........|*7 | ...................
...........|......................
.|*10|---| 1 |---| 2 |--| 3 |.....
...........|.......|......|.......
.........|*5 | ..|*4 |----|.......
...........|......................
.........| 6 | ...................